P;.;w;w;w;w;w;w;w;w;w;w;w;w;w;w;
.;.;.;.;.;.;.;.;.;.;.;.;.;.;.;w;
w;w;w;w;w;w;w;w;w;w;w;w;e;.;e;w;
w;.;.;.;.;.;.;.;.;.;.;.;.;.;.;w;
w;.;w;.;.;.;w;.;e;.;w;w;w;w;w;w;
w;.;w;w;w;w;w;w;w;w;w;.;.;.;.;w;
w;.;w;.;w;.;.;.;.;.;w;.;e;.;.;w;
w;.;.;.;w;.;.;.;.;.;w;.;.;.;.;w;
w;.;w;w;w;.;w;w;w;w;w;w;w;w;.;w;
w;.;.;.;w;.;.;.;.;.;.;.;.;w;.;w;
w;w;w;.;w;.;w;w;w;w;w;w;w;w;.;w;
w;.;.;.;w;.;.;.;.;w;.;.;w;w;.;w;
w;.;w;w;w;.;.;w;.;w;.;e;.;w;.;w;
w;.;.;.;.;e;.;w;.;w;.;w;.;w;.;w;
w;.;.;.;.;.;.;w;.;.;.;w;.;.;.;w;
w;w;w;w;w;w;w;w;w;w;w;w;w;w;w;w;